################################################################################
################################################################################
################################################################################
###################################################......#######################
###################################################......#######################
###########.....###################################......#######################
###########.....###################################......#######################
###########.......###.........#.......#############.......######################
##########........##...........E......###########.........###########.........##
########..............................###########.............................##
.###...................####...................................................##
......................##########..............................................##
............................................E...........#############E........##
....X...................................................########################
.........................................E..............########################
........###...##############.......E#########...........########################
#.##...#.###################.......##########.....@.....########################
###########################.....#############...........########################
###########################....#############.........###########################
###########################....#############.........###########################
###########################...############......#..##.##########################
###########################......#####.........#################################
#####################..........................#################################
#####################........................###################################
#####################....................#######################################
#####################.................##########################################
#####################..............#############################################
################################################################################
################################################################################
################################################################################

seed=12347 stamp=12347 exit_pos=(4, 13) player_pos=(50, 16)
